{
    "level": 2,
    "map": [
      [0, 0, 0, 0, 1, 1, 1, 1, 1, 0, 0, 0, 0, 0, 0, 0, 0, 0, 0, 0, 0, 0],
      [0, 0, 0, 0, 1, 0, 0, 0, 1, 0, 0, 0, 0, 0, 0, 0, 0, 0, 0, 0, 0, 0],
      [0, 0, 0, 0, 1, 3, 0, 0, 1, 0, 0, 0, 0, 0, 0, 0, 0, 0, 0, 0, 0, 0],
      [0, 0, 1, 1, 1, 0, 0, 3, 1, 1, 1, 0, 0, 0, 0, 0, 0, 0, 0, 0, 0, 0],
      [0, 0, 1, 0, 0, 3, 0, 0, 3, 0, 1, 0, 0, 0, 0, 0, 0, 0, 0, 0, 0, 0],
      [1, 1, 1, 0, 1, 0, 1, 1, 1, 0, 1, 0, 0, 0, 0, 0, 1, 1, 1, 1, 1, 1],
      [1, 0, 0, 0, 1, 0, 1, 1, 1, 0, 1, 1, 1, 1, 1, 1, 1, 0, 0, 4, 4, 1],
      [1, 0, 3, 0, 0, 3, 0, 0, 0, 0, 0, 0, 0, 0, 0, 0, 0, 0, 0, 4, 4, 1],
      [1, 1, 1, 1, 1, 0, 1, 1, 1, 1, 0, 1, 2, 1, 1, 1, 1, 0, 0, 4, 4, 1],
      [0, 0, 0, 0, 1, 0, 0, 0, 0, 0, 0, 1, 1, 1, 0, 0, 1, 1, 1, 1, 1, 1],
      [0, 0, 0, 0, 1, 1, 1, 1, 1, 1, 1, 1, 0, 0, 0, 0, 0, 0, 0, 0, 0, 0]
    ],
    "player": { "x": 12, "y": 8 },
    "boxes": [
        { "x": 5, "y": 2 },
        { "x": 7, "y": 3 },
        { "x": 5, "y": 4 },
        { "x": 8, "y": 4 },
        { "x": 5, "y": 7 },
        { "x": 2, "y": 7 }
    ],
    "goals": [
        { "x": 19, "y": 6 },
        { "x": 20, "y": 6 },
        { "x": 19, "y": 7 },
        { "x": 20, "y": 7 },
        { "x": 19, "y": 8 },
        { "x": 20, "y": 8 }
    ]
  }